9 9
1 2 3
0 B1 0 0 B2 0 0 B3 0 
0 0 0 0 0 0 0 0 0 
0 0 0 0 0 0 0 0 0 
0 0 0 0 0 x x x x 
0 0 0 0 0 0 0 0 0 
0 0 0 x x x x 0 0 
0 0 0 0 0 0 0 0 0 
0 0 0 0 S 0 0 0 0 
0 0 0 0 x 0 0 0 0 